azospermia: brak plemników
conceive: począć
conception:poczęcie
defective: uszkodzony
displacement:przemieszczenie
ectopic pregnancy: ciąża pozamaciczna
endometriosis: gruczolistość
fallopian tube: jajowód
Favourable: sprzyjający
fertilize:zapłodnić
fibroid: włóknistu
gonorrhoea: rzeżączka
hostile: wrogi
hypogonadism: niedoczynność gonad
immobilize: unieruchomić
infertility: bezpłodność
insemination: zaplemnienie
malformation: wada rozwojowa
myoma:mięśniak
oligospermia: za mało plemników
orchitis: zapalenie jąder
ovary: jajnik
ovi duct: Jajowód
ovum: jajo
Patent:drożny
testis pl testes: jądro/a
testicle: jądro
undescended: niezastąpione
refers:nazywać, zwracać się 
Achieve: osiągać, zdobywać
couples: para
Conception : poczęcie, zapłodnienie
Social : społeczny, socjalny
presently : niebawem, wkrótce
reproductive organs: organy rozrodcze
vagina: pochwa
cervix: szyjka macicy
uterus: macisa
patent: jawny, oczywisty
mucus secreted: wydzielanie sluzu
favourable: pomyślny
reaching : uzyskiwać, osiągać
anovulation: brak jajeczkowania,
disorder : choroba ,zaburzenia
obstruction : zablokowanie, zatkanie
antibodies : przeciwciala
Immobilize : pobudzac, aktywowac
hostile mucus : nieprzyjazna wydzielina .....
fibroids: wlokniaki
myomas: miesniak
polyps : polipy
uterine displacement : przesuniecie macicy
endocrine disorders : zaburzenia hormonalne
undescended testicle: niezstąpione jądra
defective sperm : wybrakowane nasienie
requires : potrzebować
gynaecologist : ginekolog
urologist : urolog
in vitro fertilizations : zaplodnienie in vitro
unprotected sex : brak zabezpieczenia
natural contraception : antykoncepcja naturalna
oral contraceptive: tabletki antykoncepcyjne
condom : prezerwatywa
intrauterine device IUD: wkladka wewnatrzmaciczna
Coil: spirala
diaphragm: kapturek
Spermicides: srodek plemnikobojczy
male sterilization : sterylizacja/  ubezplodnienie mezczyzny
vasectomy: sterylizacja meska
emergency contraception: Tabletka wczesnoporonna
the "morning after pill" : tabletka Wczesnoporonna
abortion pill : tabletka wczesnoporonna
miscarriage : poronienie
abortion : aborcja
be pregnant : byc w ciazy
get pregnant : zajsc w ciaze
unexpected pregnancy : nieoczekiwana ciaza
sexually transmitted diseases : choroby przenoszonedroga plciowa
Impregnate : zaplodnic
inseminate : zaplemnic 
vaginitis: zapalenie pochwy 
Amenorrhoea : brak miesiaczki
Hormonal disturbance: zaburzena hormonalne
blockage of the spermic ducts : zablokowany nasieniowod
mumps : swinka
injury to the genitals : uszkodzenia genitali
congenital defects : wrodzonedefektg
chromosomal abnormality : nieprawidlowosc chromosomalna
corrective surgery : operacja korekcyjna
As a result : z powodu