alveolus - pêcherzyk p³ucny
respiratory system - uk³ad oddechowy
sac  - pêcherzyk
tonsil - migda³ek
visceral - trzewny
attach - przy³¹czyæ
basc - podstawa
bloodstream - krwioobieg
pharynx - gard³o
larynx - Krtañ
trachea - tchawica
bronchi (pl), bronchus (sing)  - oskrzela
bronchiole - oskrzelik
cone - sto¿ek
factor - czynnik
hoarseness - chrypka
hurt - zranienie
laryngopharynx - krtaniowa czêœæ gard³a
line - linia, wyœcieliæ
lobe - p³at
lung - p³uco
alveoli of the lungs - pêcherzyki plucne
nasal septum - przegroda nosowa
nasal cavity - jama nosowa
posteriorly - ty³owi
nasopharynx - czêœæ nosowa gard³a
oropharynx - czêœæ ustna gard³a
parietal - œcienny
cartilages - chrz¹stki
vocal cords - struny g³osowe
capillaries - naczynka
lobes - p³aty
serous membrane - b³ona surowicza
pleura - op³ucna
clavicle - obojczyk
epiglottis - nag³oœnia
sore throat - ból gard³a
auscultate - opukaæ
Thoracolumbar - piersiowo lêdŸwiowy
Pleuracotamy - drena¿ jamy op³ucnej
Pharyngoscopy - wziernikowanie gard³a
Laryngoscopy - wziernikowanie krtani
Rhinopathy - choroba nosa
Bronchoconstriction - zwê¿enie oskrzeli
Tracheospasm - skurcz tchawicy
respiration - oddychanie
reversible - odwracalny
absorb - wch³aniaæ
absorption - wch³anianie
sacs - woreczki
diffuses - przenikaæ, rozproszony, rozpraszaæ
accessory - dodatkowy, pomocniczy
accessory organs - poboczne organy
intercostal muscles - miêœni miêdzy¿ebrowych
intercostal - miêdzy¿ebrowe
involve - wci¹gn¹æ (w proces chorobowy)
ribs - ¿ebra
blaish - niebieskawy
capillary - naczynie w³osowate
consecutive - kolejny
distension - rozszerzanie
enlarge - powiêkszyæ
exhale - wydychaæ
distress - ciê¿ki stan, wyczerpanie
tonsillitis - zapalenie migda³ków
volume - objêtoœæ, pojemnoœæ
inspiration - wdech
expiration - wydech
influenza - grypa
obstruct - zatkaæ, zaczopowaæ
oxygen - tlen
rhinitis - katar, nie¿yt nosa
pharyngitis - zapalenie gard³a
laryngitis - zapalenie krtani
bronchitis - zapalenie oskrzeli
pneumonia - zapalenie p³uc
pleuritis - zapalenie op³ucnej
spasmodic - spazmatyczny, skurczowy
contraction - skurcz
bronchospasm - skurcz oskrzeli
pollen - py³ek
Emphysema - rozedma
alveoli - pêcherzyki p³ucne
enzyme - enzym
respiratory distress syndrome - zespó³ zaburzeñ oddechowych
benign - ³agodny
sputum production - odkrztuszanie plwociny
nasal discharge - wydzielina z nosa
haemoptysis - krwioplucie
cyanosis - sinica
malaise - z³e samopoczucie
air sac - Pêcherzyk p³ucny
armpit - pacha 
collarbone - Obojczyk
kneecap - rzepka
limb - koñczyna
shoulder blade - ³opatka
small of the back - krzy¿
spinal column - krêgos³up
voice box - krtañ
windpipe - Tchawica
flexible - giêtki
anemia - anemia
fluid - p³yn
carbon dioxide - dwutlenek wêgla
plasma - osocze krwi
carbohydrates - wêglowodany
dissolved - rozpuszczony
dissolve - rozpuœciæ
dizziness - zawrót g³owy
suspended - zawieszony
lung capillary - kapilary p³uc
granulocytes - granulocyty
basophils - bazofile, leukocyt zasadoch³onny
eosinophils - granulocyt eozynoch³onny
neutrophils - neutrofil, granulocyt obojêtnoch³onny
monocytes - monocyty
ingest - przyjmowaæ pokarm,
blood coagulation, blood clotting - krzepniêcia krwi
coagulation - krzepniêcie
pale - blady
leukaemia - bia³aczka
bone marrow - szpik kostny
lymph nodes - wêz³y ch³onne
oedema - oty³oœæ, obrzêk
dyspnoea - dusznoœæ
exertion - wysi³ek
angina pectoris - dusznica bolesna
ventricular hypertrophy - przeróst komór
strain- odkszta³cenie
diuretics - diuretyki
phlebitis - zapalenie ¿y³y
cardiomegaly - powiêkszenie serca
Hematologi - nauka o krwi
Sanguinopoietic - krwiotwórczy
Angiography - angiografia
Vascularity - unaczynienie
malignant neoplasm - z³oœliwy nowotwór
malignant - z³oœliwy
connective tissue - tkanka ³¹czna
constituent - sk³adnik
count - iloœæ, liczyæ
deffensive mechanism - mechanizm obronny
decrease - zmniejszaæ
deficiency - niedobór
enlargement - powiêkszenie
erythrocyte - erytrocyt, krwinka czerwona
haemoglobin - hemoglobina
impair - upoœledziæ, uszkodziæ
increase - wzrastaæ
leukocyte - leukocyt, krwinka bia³a
leukocytosis - leukocytoza, zwiêkszony poziom leukocytów we krwi
leukopenia - leukopenia
matrix - substancja podstawowa
multiplication - pomno¿enie
nucleated - j¹drzasty 
obese - oty³y
sedimentation rate - szybkoœæ opadania
thrombocyte - trombocyt, p³ytka krwi
Cardiovascular system - uk³ad sercowo-naczyniowy
blood vessels - naczynia krwionoœne
arteries - têtnice
arterioles - têtniczki
capillaries - naczynka
venules - ¿y³ki
cone-shaped - sto¿kowy
hollow - pusty
apex - wierzcho³ek
pericardium - osierdzie
myocardium - miêsieñ sercowy
endocardium - wsierdzie
atrium, atria, auricles - przedsionki
pericarditis - zapalenie osierdzia
ventricles - komory
atrioventricular - przedsionkowo komorowy
mitral valve, bicuspid valve - zastawka mitralna, zastawka dwudzielna
tricuspid valve - zastawka trójdzielna
flap - zapadka
pulmonary circulation - kr¹¿enie p³ucne
pulmonary vein - ¿y³y p³ucne
vena cava - ¿y³a g³ówna
hepatic vein - ¿y³a w¹trobowa
renal vein - ¿y³y nerkowej
coronary artery - wieñcowa
abdominal - brzuszny
trunk - tu³ów
congenital - wrodzony
patent ductus arteriosus - dro¿ny przewód têtniczy
coarctation of aorta - zwê¿enie aorty
Fallot’s tetralogy - tetralogia Fallota
inflamation of aorta - Zapalenie aorty
arteriosclerosis - mia¿d¿yca
clot - skrzep, grudka
myocardial infraction - zawa³ miêœnia sercowego
hypertension - nadciœnienie
heredity - dziedzicznoœæ
heart murmurs - szmery serca
severe - ciê¿ki
auscultation - os³uchiwanie
percussion - opukanie
ankle swelling - obrzêk stawu skokowego
kidney - nerka
coronary angioplasty - angioplastyka wieñcowa
accompany - towarzyszyæ
acquired - nabyty
arteriole - têtniczka
atria - przedsionek
coronary circulation - kr¹¿enie wieñcowe
endocarditis - zapalenie wsierdzia
lumen - œwiat³o (przewodu)
myocarditis - zapalenie miêœnia sercowego
portal circulation - kr¹¿enie wrotne
pulmonary - p³ucny
septum - przegroda
spread - rozprzestrzeniaæ
systemic circulation - kr¹¿enie ogólnoustrojowe
thrombus - skrzeplina
tightness - ciasnota, œciskanie
valve - zastawka
vein - ¿y³a
ventricle - komora (sercowa)
venule - ¿y³ka
digestive - trawienny
digestive system - uk³ad pokarmowy
tissues - tkanki
gastrointestinal system - Uk³ad pokarmowy
oesophagus - prze³yk
intestine - Jelito
salivary glands - œlinianki
salivary gland - gruczo³ œlinowy 
parotid - przyuszny
submandibular - pod¿uchwowy
sublingual glands - gruczo³y podjêzykowe
saliva - œlina
Eustachian tube - tr¹bka Eustachiusza
tonsils - migda³ki
thorax - klatka piersiowa
sack - worek
ovoid - jajowaty
diaphragm - przepona
mucous membrane - b³ona œluzowa
hydrochloric acid - kwas solny
digestion - trawienie
cardiac sphincter - zwieracza serca
pyloric sphincter - zwieracza odŸwiernika
duodenum - dwunastnica
jejunum - jelita czczego
ileum - jelito krête, krêtnica
bile duct - przewód ¿ó³ciowy
caecum - k¹tnica
colon - okrê¿nica
vermiform appendix - wyrostek robaczkowy
ascending colon - okrê¿nica wstêpuj¹ca
transverse colon - okrê¿nica poprzeczna 
descending colon - okrê¿nica zstêpuj¹ca
sigmoid colon - esica, okrê¿nica esowata 
rectum - prostnica, odbytnica
terminal  part - koñcowa czêœæ
anus - odbyt
gallbladder - woreczek ¿ó³ciowy, pêcherzyk ¿ó³ciowy
pancreas - trzustka
parotid gland - Œlinianka przyuszna   
submaxillary gland- Œlinianka pod¿uchwowa
sublingual gland - Œlinianka podjêzykowa
spleen - sledziona
secrete - wydziela
bowel - jelito
cecum - jelito œlepe
bowel movements - wypró¿nienia
diarrhoea - biegunka
Gastritis -  nie¿yt ¿o³¹dka
Duodenopathy - choroba dwunastnicy
Colitis - nie¿yt jelita grubego
Rectostenosis - zwê¿enie odbytnicy
Cholecystis - zapalenie pêcherzyka ¿ó³ciowego
Anovesical - odbytowo-pêcherzowy
Hepatitis - zapalenie w¹troby
Pancreatitis - zapalenie trzustki
cardia - wpust
gastric juice - sok ¿o³¹dkowy
gum - dzi¹s³o
liver - w¹troba
muscular - miêœniowy
nausea - nudnoœci
pylorus - odŸwiernik
relieve - z³agodziæ
sigmoid - esica
stomach - ¿o³¹dek
sublingual - podjêzykowy
throat - Gard³o
tongue - jêzyk
vomit - wymiotowaæ