abdomen : jama brzuszna
affect : atakowaæ
ankle : kostka u nogi
arm : ramiê
armpit : pacha
bend : schylaæ siê, zginaæ
body : cia³o
bone : koœæ
calf : ³ydka
cavity : jama
cell : komórka
cheek : policzek
chest : klatka piersiowa
chin : broda, podbródek
consist : sk³adaæ siê
diaphragm : przepona
elbow : ³okieæ
eye : oko
eyelash: rzêsa
eyelid : powieka
face : twarz
foot, (pl. feet) : stopa, stopy
forearm : przedramiê
forehead : czo³o
groin : pachwina
hand : rêka, d³oñ
head : g³owa
heart : serce
hollow : wydr¹¿ony
hip : biodro
joint : staw
knee : kolano
leg : podudzie
limb : koñczyna
lip : warga
loin : lêdŸwie
maintain : utrzymaæ (na tym samym poziomie)
mouth : usta
navel : pêpek
neck : szyja
nose : nos
overdo : przemêczyæ siê
radiate : promieniowaæ
shoulder : bark
skull : czaszka
spine : krêgos³up
stab : wbiæ, uk³uæ
thigh : udo
thorax : Klatka piersiowa
thumb : kciuk
tingling : mrowienie, cierpniêcie
tissue : tkanka
toe : palec u nogi
trunk : tu³ów
wrist : nadgarstek
palm : d³oñ
Finger nail : paznokieæ
heel : piêta
instep : stêp
composed of : sk³ada siê
unite : jednoczyæ siê
the ciculatory system : system kr¹¿enia
ovoid : jajowaty
joints : stawy
shoe laces : sznurowad³a
sensation : uczucie