respiration : oddychanie
reversible : odwracalny
absorb : wch³aniaæ
absorption : wch³anianie
sacs : woreczki
diffuses : przenikaæ, rozproszony, rozpraszaæ
accessory : dodatkowy, pomocniczy
accessory organs : poboczne organy
intercostal muscles : miêœni miêdzy¿ebrowych
intercostal : miêdzy¿ebrowe
involve : wci¹gn¹æ (w proces chorobowy)
ribs : ¿ebra
blaish : niebieskawy
capillary : naczynie w³osowate
consecutive : kolejny
distension : rozszerzanie
enlarge : powiêkszyæ
exhale : wydychaæ
distress : ciê¿ki stan, wyczerpanie
tonsillitis : zapalenie migda³ków
volume : objêtoœæ, pojemnoœæ
inspiration : wdech
expiration : wydech
influenza : grypa
obstruct : zatkaæ, zaczopowaæ
oxygen : tlen
rhinitis : katar, nie¿yt nosa
pharyngitis : zapalenie gard³a
laryngitis : zapalenie krtani
bronchitis : zapalenie oskrzeli
pneumonia : zapalenie p³uc
pleuritis : zapalenie op³ucnej
spasmodic : spazmatyczny, skurczowy
contraction : skurcz
bronchospasm : skurcz oskrzeli
pollen : py³ek
Emphysema : rozedma
alveoli : pêcherzyki p³ucne
enzyme : enzym
respiratory distress syndrome : zespó³ zaburzeñ oddechowych
benign : ³agodny
sputum production : odkrztuszanie plwociny
nasal discharge : wydzielina z nosa
haemoptysis : krwioplucie
cyanosis : sinica
malaise : z³e samopoczucie
air sac : Pêcherzyk p³ucny
armpit : pacha 
collarbone : Obojczyk
kneecap : rzepka
limb : koñczyna
shoulder blade : ³opatka
small of the back : krzy¿
spinal column : krêgos³up
voice box : krtañ
windpipe : Tchawica
flexible : giêtki