acne : tr¹dzik
carbon dioxide : dwutlenek wêgla
crust : strup
damage : szkoda, uszkodzenie, uszkodziæ
dermatitis : zapalenie skóry
dermatomycosis : grzybica
dissolved : rozpuszczony
ear wax : woskowina uszna
eczema : egzema
erythema : rumieñ
evaporate : parowaæ, ulatniaæ siê
excessive : nadmierny
excoriation : otarcie skóry, zadrapanie
excretory organ : organ wydalniczy
expose : wystawiæ, naraziæ
fissure : szczelina, pêkniêcie
furuncle : czyrak nogi
injury : zranienie, uszkodzenie
irritation : podra¿nienie
itch : sfêdzieæ
lesion : uszkodzenie, zmiana chorobowa
mole : znamiê
ointment : maœæ
perspiration : pocenie siê
protection : ochrona
provide : dostarczyæ, zaopatrzyæ
psoriasis : ³uszczyca
rash : wysypka
relieve : z³agodziæ
retain : zatrzymywaæ, powstrzymywaæ
scabies : œwierzb
scratch : drapaæ
sebum : ³ój skórny
secretion : wydzielanie
stimulus (pl.) stimuli : bodziec
trigger  : wyzwoliæ, spowodowaæ
ulcer : wrzód
waterproof : wodoodporny
wax : wosk
sensory organ : organ zmys³owy
rays : promienie
coat : p³aszcz
rapid : szybkie
quantity : iloœæ
constant : sta³y
continuously : ci¹g³y
nerve endings : zakoñczenia nerwowe
various : ró¿norodny
pressure : ciœnienie
viral : wirusowy
fungal : grzybicze
parasites : paso¿yty
melanoma : czerniak
harmful : szkodliwe
adolescence : wiek m³odzieñczy
reddened : zaczerwieniona
swollen : spuchnia³y