Cardiovascular system : uk³ad sercowo:naczyniowy
blood vessels : naczynia krwionoœne
arteries : têtnice
arterioles : têtniczki
capillaries : naczynka
venules : ¿y³ki
cone-shaped : sto¿kowy
hollow : pusty
apex : wierzcho³ek
pericardium : osierdzie
myocardium : miêsieñ sercowyop
endocardium : wsierdzie
atrium, atria, auricles : przedsionki
pericarditis : zapalenie osierdzia
ventricles : komory
atrioventricular : przedsionkowo komorowy
mitral valve, bicuspid valve : zastawka mitralna, zastawka dwudzielna
tricuspid valve : zastawka trójdzielna
flap : zapadka
pulmonary circulation : kr¹¿enie p³ucne
pulmonary vein : ¿y³y p³ucne
vena cava : ¿y³a g³ówna
hepatic vein : ¿y³a w¹trobowa
renal vein : ¿y³y nerkowej
coronary artery : wieñcowa
abdominal : brzuszny
trunk : tu³ów
congenital : wrodzony
patent ductus arteriosus : dro¿ny przewód têtniczy
coarctation of aorta : zwê¿enie aorty
Fallot’s tetralogy : tetralogia Fallota
inflamation of aorta : Zapalenie aorty
arteriosclerosis : mia¿d¿yca
clot : skrzep, grudka
myocardial infraction : zawa³ miêœnia sercowego
hypertension : nadciœnienie
heredity : dziedzicznoœæ
heart murmurs : szmery serca
severe : ciê¿ki
auscultation : os³uchiwanie
percussion : opukanie
ankle swelling : obrzêk stawu skokowego
kidney : nerka
coronary angioplasty : angioplastyka wieñcowa
accompany : towarzyszyæ
acquired : nabyty
arteriole : têtniczka
atria : przedsionek
coronary circulation : kr¹¿enie wieñcowe
endocarditis : zapalenie wsierdzia
lumen : œwiat³o (przewodu)
myocarditis : zapalenie miêœnia sercowego
portal circulation : kr¹¿enie wrotne
pulmonary : p³ucny
septum : przegroda
spread : rozprzestrzeniaæ
systemic circulation : kr¹¿enie ogólnoustrojowe
thrombus : skrzeplina
tightness : ciasnota, œciskanie
valve : zastawka
vein : ¿y³a
ventricle : komora (sercowa)
venule : ¿y³ka