blood vessel : naczynie krwionoœne
connective tissue : tkanka ³¹czna
dermis : skóra w³aœciwa
epidermis : naskórek
epithelium : nab³onek
flat : p³aski
hair : w³osy
keratinization : rogowacenie, keratynizacja
layer : Warstwa
mammary gland : gruczo³ mleczny
melanin : melanina
nail : paznokieæ
sebaceous gland : gruczo³ ³ojowy
skin : skóra
sole : podeszwa
subcutaneous : podskórny
sweat gland : gruczo³ potowy
tough : mocny wytrzyma³y
duct : kana³
cornified : zrogowacia³y
stratum : warstwa
germinativum : germinativum
arrector : arrector
papilla : brodawka
follicle : pêcherzyk
lymph vessels : naczyñ limfatycznych
fingerprints  : odciski palców
fat : t³uszcz
Adenoma : rak gruczo³owy
Lymphocytosis : limfocytoza
Dermatology : dermatologia
Myocardium : miêsieñ sercowy
Cephalomegaly : wielkog³owie
Brachiocephalic : ramieniowo-g³owowy