alveolus : pêcherzyk p³ucny
respiratory system : uk³ad oddechowy
sac  : pêcherzyk
tonsil : migda³ek
visceral : trzewny
attach : przy³¹czyæ
basc : podstawa
bloodstream : krwioobieg
pharynx : gard³o
larynx : Krtañ
trachea : tchawica
bronchi (pl), bronchus (sing)  : oskrzela
bronchiole : oskrzelik
cone : sto¿ek
factor : czynnik
hoarseness : chrypka
hurt : zranienie
laryngopharynx : krtaniowa czêœæ gard³a
line : linia, wyœcieliæ
lobe : p³at
lung : p³uco
alveoli of the lungs : pêcherzyki plucne
nasal septum : przegroda nosowa
nasal cavity : jama nosowa
posteriorly : ty³owi
nasopharynx : czêœæ nosowa gard³a
oropharynx : czêœæ ustna gard³a
parietal : œcienny
cartilages : chrz¹stki
vocal cords : struny g³osowe
capillaries : naczynka
lobes : p³aty
serous membrane : b³ona surowicza
pleura : op³ucna
clavicle : obojczyk
epiglottis : nag³oœnia
sore throat : ból gard³a
auscultate : opukaæ
Thoracolumbar : piersiowo lêdŸwiowy
Pleuracotamy : drena¿ jamy op³ucnej
Pharyngoscopy : wziernikowanie gard³a
Laryngoscopy : wziernikowanie krtani
Rhinopathy : choroba nosa
Bronchoconstriction : zwê¿enie oskrzeli
Tracheospasm : skurcz tchawicy