anterior : przedni
ascend : wstêpowaæ
caudal : doogonowy
comprise : zawieraæ, obejmowaæ sk³adaæ siê
contain : zawieraæ, mieœciæ w sobie
couch : le¿anka
cranial : czaszkowy, g³owowy
descend : zstêpowaæ
direct : skierowaæ, bezpoœredni
distal : dystalny, dalszy
dorsal : grzbietowy
downwards : na/w dó³, ku do³owi
extend : rozci¹gaæ siê, rozprzestrzeniaæ siê
forwards : naprzód, ku przodowi
inferior : dolny, ni¿szy
lateral : boczny
medial : œrodkowy
parallel : równoleg³y
pass : przejœcie, przechodziæ
posterior : tylny
proximal : proksymalny, bli¿szy
side : strona, bok
structure : struktura, budowla
superior : górny, wy¿szy
surface : powierzchnia, zewnêtrzna strona
trachea : tchawica
upright : wyprostowany
ventral : brzuszny
superficial : powierzchowny
oesophagus : prze³yk