anemia : anemia
fluid : p³yn
carbon dioxide : dwutlenek wêgla
plasma : osocze krwi
carbohydrates : wêglowodany
dissolved : rozpuszczony
dissolve : rozpuœciæ
dizziness : zawrót g³owy
suspended : zawieszony
lung capillary : kapilary p³uc
granulocytes : granulocyty
basophils : bazofile, leukocyt zasadoch³onny
eosinophils : granulocyt eozynoch³onny
neutrophils : neutrofil, granulocyt obojêtnoch³onny
monocytes : monocyty
ingest : przyjmowaæ pokarm,
blood coagulation, blood clotting : krzepniêcia krwi
coagulation : krzepniêcie
pale : blady
leukaemia : bia³aczka
bone marrow : szpik kostny
lymph nodes : wêz³y ch³onne
oedema : oty³oœæ, obrzêk
dyspnoea : dusznoœæ
exertion : wysi³ek
angina pectoris : dusznica bolesna
ventricular hypertrophy : przeróst komór
strain: odkszta³cenie
diuretics : diuretyki
phlebitis : zapalenie ¿y³y
cardiomegaly : powiêkszenie serca
Hematologi : nauka o krwi
Sanguinopoietic : krwiotwórczy
Angiography : angiografia
Vascularity : unaczynienie
malignant neoplasm : z³oœliwy nowotwór
malignant : z³oœliwy
connective tissue : tkanka ³¹czna
constituent : sk³adnik
count : iloœæ, liczyæ
deffensive mechanism : mechanizm obronny
decrease : zmniejszaæ
deficiency : niedobór
enlargement : powiêkszenie
erythrocyte : erytrocyt, krwinka czerwona
haemoglobin : hemoglobina
impair : upoœledziæ, uszkodziæ
increase : wzrastaæ
leukocyte : leukocyt, krwinka bia³a
leukocytosis : leukocytoza, zwiêkszony poziom leukocytów we krwi
leukopenia : leukopenia
matrix : substancja podstawowa
multiplication : pomno¿enie
nucleated : j¹drzasty 
obese : oty³y
sedimentation rate : szybkoœæ opadania
thrombocyte : trombocyt, p³ytka krwi